####################
#..................#
#..................#
#..................#
#..................#
#..........B.......#
#..................#
#......b...........#
#..................#
#..................#
#..................#
#........P.........#
####################